NO ./textures/north.xpm
WE ./textures/west.xpm
SO ./textures/south.xpm
EA ./textures/east.xpm

F 0,128,0
C 173,216,230

        1111111111111111111111111
        1000000000110000000000001
        1011000001110000000000001
        1001000000000000000000001
111111111011000001110000000000001
100000000011000001110111111111111
11110100001111011100000000001
11110111100011011101010000001
11000000110100100000000000001
10000000000000001100000000001
10000000000000001101010000001
11000001110101011111011110W0111
11110111 1110101 101111010001
11111111 1111111 111111111111
